"filename", "language", "Dart", "comment", "blank", "total"
"g:\Local Disk F\Source Codes\Flutter\docare\lib\components\assets_path.dart", "Dart", 14, 3, 6, 23
"g:\Local Disk F\Source Codes\Flutter\docare\lib\components\colors.dart", "Dart", 37, 0, 16, 53
"g:\Local Disk F\Source Codes\Flutter\docare\lib\components\components_barrel.dart", "Dart", 8, 1, 2, 11
"g:\Local Disk F\Source Codes\Flutter\docare\lib\components\pick_image.dart", "Dart", 22, 0, 4, 26
"g:\Local Disk F\Source Codes\Flutter\docare\lib\components\primary_button.dart", "Dart", 44, 0, 2, 46
"g:\Local Disk F\Source Codes\Flutter\docare\lib\components\secondary_button.dart", "Dart", 14, 1, 2, 17
"g:\Local Disk F\Source Codes\Flutter\docare\lib\components\snack_bar.dart", "Dart", 34, 5, 2, 41
"g:\Local Disk F\Source Codes\Flutter\docare\lib\components\text.dart", "Dart", 21, 0, 3, 24
"g:\Local Disk F\Source Codes\Flutter\docare\lib\components\textfield.dart", "Dart", 45, 5, 4, 54
"g:\Local Disk F\Source Codes\Flutter\docare\lib\components\time_format.dart", "Dart", 15, 0, 2, 17
"g:\Local Disk F\Source Codes\Flutter\docare\lib\components\url_launcher.dart", "Dart", 12, 3, 2, 17
"g:\Local Disk F\Source Codes\Flutter\docare\lib\main.dart", "Dart", 340, 19, 29, 388
"g:\Local Disk F\Source Codes\Flutter\docare\lib\models\appointments.dart", "Dart", 76, 2, 4, 82
"g:\Local Disk F\Source Codes\Flutter\docare\lib\models\date_time.dart", "Dart", 0, 15, 4, 19
"g:\Local Disk F\Source Codes\Flutter\docare\lib\models\doctor_model.dart", "Dart", 62, 2, 4, 68
"g:\Local Disk F\Source Codes\Flutter\docare\lib\models\user_model.dart", "Dart", 32, 2, 4, 38
"g:\Local Disk F\Source Codes\Flutter\docare\lib\navigation\navigator.dart", "Dart", 14, 0, 3, 17
"g:\Local Disk F\Source Codes\Flutter\docare\lib\network\connection.dart", "Dart", 0, 8, 2, 10
"g:\Local Disk F\Source Codes\Flutter\docare\lib\no_network.dart", "Dart", 119, 16, 13, 148
"g:\Local Disk F\Source Codes\Flutter\docare\lib\public_packages.dart", "Dart", 6, 1, 2, 9
"g:\Local Disk F\Source Codes\Flutter\docare\lib\push_notification\push_notidication.dart", "Dart", 64, 41, 33, 138
"g:\Local Disk F\Source Codes\Flutter\docare\lib\push_notification\send_push_notification.dart", "Dart", 3, 32, 3, 38
"g:\Local Disk F\Source Codes\Flutter\docare\lib\screens\doctor_screens\appointment_screen.dart", "Dart", 417, 130, 30, 577
"g:\Local Disk F\Source Codes\Flutter\docare\lib\screens\doctor_screens\doctor_information_screen.dart", "Dart", 465, 41, 26, 532
"g:\Local Disk F\Source Codes\Flutter\docare\lib\screens\doctor_screens\doctor_profile_screen.dart", "Dart", 208, 25, 10, 243
"g:\Local Disk F\Source Codes\Flutter\docare\lib\screens\user_screens\appointment_booked.dart", "Dart", 67, 2, 7, 76
"g:\Local Disk F\Source Codes\Flutter\docare\lib\screens\user_screens\appointment_screen.dart", "Dart", 370, 21, 14, 405
"g:\Local Disk F\Source Codes\Flutter\docare\lib\screens\user_screens\doctor_info_screen.dart", "Dart", 623, 84, 55, 762
"g:\Local Disk F\Source Codes\Flutter\docare\lib\screens\user_screens\fav_screen.dart", "Dart", 164, 2, 9, 175
"g:\Local Disk F\Source Codes\Flutter\docare\lib\screens\user_screens\home_screen.dart", "Dart", 460, 126, 34, 620
"g:\Local Disk F\Source Codes\Flutter\docare\lib\screens\user_screens\login_screen.dart", "Dart", 330, 28, 17, 375
"g:\Local Disk F\Source Codes\Flutter\docare\lib\screens\user_screens\onboarding_screens.dart", "Dart", 150, 8, 12, 170
"g:\Local Disk F\Source Codes\Flutter\docare\lib\screens\user_screens\otp_verification_screen.dart", "Dart", 244, 24, 16, 284
"g:\Local Disk F\Source Codes\Flutter\docare\lib\screens\user_screens\profile_screen.dart", "Dart", 204, 24, 11, 239
"g:\Local Disk F\Source Codes\Flutter\docare\lib\screens\user_screens\role_screen.dart", "Dart", 132, 1, 11, 144
"g:\Local Disk F\Source Codes\Flutter\docare\lib\screens\user_screens\screen_tobe_shown.dart", "Dart", 19, 9, 5, 33
"g:\Local Disk F\Source Codes\Flutter\docare\lib\screens\user_screens\screens_barrel.dart", "Dart", 6, 0, 0, 6
"g:\Local Disk F\Source Codes\Flutter\docare\lib\screens\user_screens\user_information_screen.dart", "Dart", 173, 34, 14, 221
"g:\Local Disk F\Source Codes\Flutter\docare\lib\shared_preferences\logged_in_role.dart", "Dart", 14, 5, 7, 26
"g:\Local Disk F\Source Codes\Flutter\docare\lib\shared_preferences\screens_state_manager.dart", "Dart", 13, 4, 6, 23
"g:\Local Disk F\Source Codes\Flutter\docare\lib\shared_preferences\shared_pref_barrel.dart", "Dart", 3, 0, 1, 4
"g:\Local Disk F\Source Codes\Flutter\docare\lib\shared_preferences\theme_shared_preferences.dart", "Dart", 12, 0, 4, 16
"g:\Local Disk F\Source Codes\Flutter\docare\lib\state_management\appointment_provider.dart", "Dart", 236, 47, 30, 313
"g:\Local Disk F\Source Codes\Flutter\docare\lib\state_management\auth_provider.dart", "Dart", 275, 40, 39, 354
"g:\Local Disk F\Source Codes\Flutter\docare\lib\state_management\bottom_narbar_provider.dart", "Dart", 19, 0, 8, 27
"g:\Local Disk F\Source Codes\Flutter\docare\lib\state_management\doctor_info_screen.dart", "Dart", 25, 12, 16, 53
"g:\Local Disk F\Source Codes\Flutter\docare\lib\state_management\network.dart", "Dart", 21, 0, 3, 24
"g:\Local Disk F\Source Codes\Flutter\docare\lib\state_management\providers_barrel.dart", "Dart", 4, 0, 1, 5
"g:\Local Disk F\Source Codes\Flutter\docare\lib\state_management\theme_provider.dart", "Dart", 18, 0, 4, 22
"g:\Local Disk F\Source Codes\Flutter\docare\lib\theme\theme_style.dart", "Dart", 37, 63, 4, 104
"Total", "-", 5691, 886, 540, 7117